11111111111111111111111111111111111111111111111111111111         
10000000001100000000000011000000011000001000000100000001 
1H11000001110000000000001100000N001110000010000010000001 
10010000000000000000000011000000000000010000000000000001
111111111011000001010000010000001111111111011000111H1001
10000000001100000111110111111111110010000000001100000111
1111011111111111110000001000111110111101011H110000000101
11110111111111011101010000001111101111111110110010100001
11000000110101011110000010000H00000001101010111100000101
10000000100000001100000100011110000000100000001000000101
10000000000000001101010010001100000000000000011010100101
11000001110101011111111110011100000111010101111101111001
11111111010100000000000111111111111101011111000000011H11
1110000000H11111100000H110000000000011H11111111111111011  
10000000000000000000000010000000000100000000011000001001    
10110000011100000000000010000000001011000001110000010001   
100100000000000000000000111111110001001000000H0000000001
111111111H1100000101000000000000111111111101110000101001
10000000001100000111110111111111110000000001100000111111
11110111111111111100000010001111100111111111011100000011
11110111111111011101010000001111101111111110111010100001
11000000110101011110000010001110000001101010111100000101
10000000100000001100001000000H00000001000000011000001001
10000000000000001101010010001100000000000000011010100111
11000001110101011111011110011100000111010101111101111001
11111111110111111111111111111111111111011111111111111111