NO textures/wall_1.xpm
SO textures/wall_2.xpm
WE textures/wall_3.xpm
EA textures/wall_4.xpm
F 256,0,0
C 50,50,50
1111111
1000001
100N001
1111111