NO textures/wall_1.xpm
SO textures/wall_2.xpm
WE textures/wall_3.xpm
EA textures/wall_4.xpm
F 220,100,0
C 50,50,50
1111111111
1000000001
10001
1000000001
100N
1111111111