NO textures/wall_1.xpm
SO textures/wall_2.xpm
WE textures/wall_3.xpm
EA textures/wall_4.xpm
F 220,100,0
C 50,50,50
1111111
1000001
100N001
1000000
1111111