1111111111111111111111111111111111111111111
1000000000000000000000000000000000000000001
1000000222220000000000000000000000000000001
1000000200020000000000000000000000000000001
1000000200020000000000000000000000000000001
1000000222220000000000000000000000000000001
1000000000000000000000000000000000000000001
1000000000000000000000000003030000000000001
1000000000000000000000000000000030000000001
1004444440000000000000000000000000000000001
1000000000000000000000000000000000000000001
1004444440000000000000000000000000000000001
1000000000000000000000000000000000000000001
1111111111111111111111111111111111111111111
